|------------------|
| 1               5|
|     5   9   1    |
| 6   3 2   5 7   4|
|       4 8 2      |
| 7               8|
|       1 7 3      |
| 3   1 8   6 2   7|
|     7   3   5    |
| 8               3|
|------------------|
